;vertex;edge;sccs;mem_sw;mem_peak;mem_algorithm (byte);algorithm
0;1000;200000;1;7221248;7503872;282624;pearce2
1;1000;699999;1;18083840;18362368;278528;pearce2
2;1000;9999;1;1822720;2056192;233472;pearce2
3;1000;200000;1;6774784;7004160;229376;tarjan
4;1000;699999;1;18083840;18288640;204800;tarjan
5;1000;9999;1;1822720;2019328;196608;tarjan
6;1000;200000;1;8671232;8765440;94208;nuutila2_iterative
7;1000;699999;1;18366464;18444288;77824;nuutila2_iterative
8;1000;9999;1;1826816;1896448;69632;nuutila2_iterative
9;1000;200000;1;6774784;6860800;86016;pearce2_iterative
10;1000;699999;1;18083840;18165760;81920;pearce2_iterative
11;1000;9999;1;1826816;1908736;81920;pearce2_iterative
12;1000;200000;1;7090176;7262208;172032;boost
13;1000;699999;1;20414464;20574208;159744;boost
14;1000;9999;1;1822720;1982464;159744;boost
15;1000;200000;1;8392704;8491008;98304;nuutila1_iterative
16;1000;699999;1;25341952;25444352;102400;nuutila1_iterative
17;1000;9999;1;1826816;1896448;69632;nuutila1_iterative
18;1000;200000;1;9003008;9322496;319488;pearce1
19;1000;699999;1;25718784;26034176;315392;pearce1
20;1000;9999;1;1896448;2162688;266240;pearce1
21;1000;200000;1;7991296;8318976;327680;nuutila2
22;1000;699999;1;25092096;25419776;327680;nuutila2
23;1000;9999;1;1822720;2105344;282624;nuutila2
24;1000;200000;1;6774784;7098368;323584;nuutila1
25;1000;699999;1;27557888;27877376;319488;nuutila1
26;1000;9999;1;1822720;2097152;274432;nuutila1
27;1000;200000;1;6774784;7053312;278528;pearce2
28;1000;699999;1;24346624;24625152;278528;pearce2
29;1000;9999;1;1822720;2056192;233472;pearce2
30;1000;200000;1;8220672;8454144;233472;tarjan
31;1000;699999;1;24936448;25161728;225280;tarjan
32;1000;9999;1;1822720;2019328;196608;tarjan
33;1000;200000;1;7061504;7147520;86016;nuutila2_iterative
34;1000;699999;1;18083840;18161664;77824;nuutila2_iterative
35;1000;9999;1;1826816;1896448;69632;nuutila2_iterative
36;1000;200000;1;6774784;6860800;86016;pearce2_iterative
37;1000;699999;1;21983232;22077440;94208;pearce2_iterative
38;1000;9999;1;1921024;1998848;77824;pearce2_iterative
39;1000;200000;1;7041024;7241728;200704;boost
40;1000;699999;1;22794240;22958080;163840;boost
41;1000;9999;1;1822720;1982464;159744;boost
42;1000;200000;1;9281536;9375744;94208;nuutila1_iterative
43;1000;699999;1;27840512;27926528;86016;nuutila1_iterative
44;1000;9999;1;1826816;1896448;69632;nuutila1_iterative
45;1000;200000;1;7024640;7344128;319488;pearce1
46;1000;699999;1;25194496;25509888;315392;pearce1
47;1000;9999;1;1822720;2093056;270336;pearce1
48;1000;200000;1;7299072;7639040;339968;nuutila2
49;1000;699999;1;18354176;18681856;327680;nuutila2
50;1000;9999;1;1822720;2105344;282624;nuutila2
51;1000;200000;1;6774784;7098368;323584;nuutila1
52;1000;699999;1;26398720;26722304;323584;nuutila1
53;1000;9999;1;1847296;2125824;278528;nuutila1
54;1000;200000;1;6995968;7274496;278528;pearce2
55;1000;699999;1;21241856;21520384;278528;pearce2
56;1000;9999;1;1822720;2056192;233472;pearce2
57;1000;200000;1;6774784;7004160;229376;tarjan
58;1000;699999;1;18083840;18288640;204800;tarjan
59;1000;9999;1;1822720;2019328;196608;tarjan
60;1000;200000;1;6774784;6860800;86016;nuutila2_iterative
61;1000;699999;1;18092032;18169856;77824;nuutila2_iterative
62;1000;9999;1;1826816;1896448;69632;nuutila2_iterative
63;1000;200000;1;7680000;7786496;106496;pearce2_iterative
64;1000;699999;1;25571328;25677824;106496;pearce2_iterative
65;1000;9999;1;1929216;2002944;73728;pearce2_iterative
66;1000;200000;1;7249920;7450624;200704;boost
67;1000;699999;1;23142400;23171072;28672;boost
68;1000;9999;1;1822720;1982464;159744;boost
69;1000;200000;1;8732672;8826880;94208;nuutila1_iterative
70;1000;699999;1;21188608;21286912;98304;nuutila1_iterative
71;1000;9999;1;1916928;2002944;86016;nuutila1_iterative
72;1000;200000;1;8785920;9093120;307200;pearce1
73;1000;699999;1;28557312;28876800;319488;pearce1
74;1000;9999;1;1822720;2093056;270336;pearce1
75;1000;200000;1;6807552;7151616;344064;nuutila2
76;1000;699999;1;18472960;18812928;339968;nuutila2
77;1000;9999;1;1822720;2105344;282624;nuutila2
78;1000;200000;1;6774784;7098368;323584;nuutila1
79;1000;699999;1;23351296;23666688;315392;nuutila1
80;1000;9999;1;1835008;2109440;274432;nuutila1
81;1000;200000;1;7249920;7528448;278528;pearce2
82;1000;699999;1;22863872;23142400;278528;pearce2
83;1000;9999;1;1822720;2056192;233472;pearce2
84;1000;200000;1;6774784;7004160;229376;tarjan
85;1000;699999;1;18083840;18288640;204800;tarjan
86;1000;9999;1;1822720;2019328;196608;tarjan
87;1000;200000;1;7999488;8093696;94208;nuutila2_iterative
88;1000;699999;1;18190336;18268160;77824;nuutila2_iterative
89;1000;9999;1;1826816;1896448;69632;nuutila2_iterative
90;1000;200000;1;6774784;6860800;86016;pearce2_iterative
91;1000;699999;1;18083840;18190336;106496;pearce2_iterative
92;1000;9999;1;1826816;1896448;69632;pearce2_iterative
93;1000;200000;1;6852608;7053312;200704;boost
94;1000;699999;1;20017152;20221952;204800;boost
95;1000;9999;1;1822720;1982464;159744;boost
96;1000;200000;1;6774784;6860800;86016;nuutila1_iterative
97;1000;699999;1;20267008;20348928;81920;nuutila1_iterative
98;1000;9999;1;1826816;1896448;69632;nuutila1_iterative
99;1000;200000;1;8605696;8925184;319488;pearce1
100;1000;699999;1;20176896;20492288;315392;pearce1
101;1000;9999;1;1822720;2093056;270336;pearce1
102;1000;200000;1;7495680;7831552;335872;nuutila2
103;1000;699999;1;21979136;22306816;327680;nuutila2
104;1000;9999;1;1822720;2105344;282624;nuutila2
105;1000;200000;1;7651328;7979008;327680;nuutila1
106;1000;699999;1;24686592;25014272;327680;nuutila1
107;1000;9999;1;1912832;2187264;274432;nuutila1
108;1000;200000;1;7094272;7372800;278528;pearce2
109;1000;699999;1;23351296;23629824;278528;pearce2
110;1000;9999;1;1830912;2064384;233472;pearce2
111;1000;200000;1;8863744;9068544;204800;tarjan
112;1000;699999;1;18399232;18628608;229376;tarjan
113;1000;9999;1;1822720;2019328;196608;tarjan
114;1000;200000;1;7176192;7270400;94208;nuutila2_iterative
115;1000;699999;1;27197440;27299840;102400;nuutila2_iterative
116;1000;9999;1;1826816;1896448;69632;nuutila2_iterative
117;1000;200000;1;8589312;8716288;126976;pearce2_iterative
118;1000;699999;1;26402816;26505216;102400;pearce2_iterative
119;1000;9999;1;1826816;1896448;69632;pearce2_iterative
120;1000;200000;1;8646656;8843264;196608;boost
121;1000;699999;1;24199168;24223744;24576;boost
122;1000;9999;1;1855488;2039808;184320;boost
123;1000;200000;1;6881280;6959104;77824;nuutila1_iterative
124;1000;699999;1;20537344;20623360;86016;nuutila1_iterative
125;1000;9999;1;1929216;2007040;77824;nuutila1_iterative
126;1000;200000;1;8376320;8691712;315392;pearce1
127;1000;699999;1;22786048;23105536;319488;pearce1
128;1000;9999;1;1822720;2093056;270336;pearce1
129;1000;200000;1;9211904;9547776;335872;nuutila2
130;1000;699999;1;23740416;24084480;344064;nuutila2
131;1000;9999;1;1822720;2105344;282624;nuutila2
132;1000;200000;1;7192576;7520256;327680;nuutila1
133;1000;699999;1;21811200;22126592;315392;nuutila1
134;1000;9999;1;1822720;2105344;282624;nuutila1
135;1000;200000;1;7548928;7827456;278528;pearce2
136;1000;699999;1;25317376;25595904;278528;pearce2
137;1000;9999;1;1822720;2056192;233472;pearce2
138;1000;200000;1;7958528;8187904;229376;tarjan
139;1000;699999;1;18034688;18239488;204800;tarjan
140;1000;9999;1;1822720;2019328;196608;tarjan
141;1000;200000;1;8851456;8941568;90112;nuutila2_iterative
142;1000;699999;1;28499968;28598272;98304;nuutila2_iterative
143;1000;9999;1;1912832;1994752;81920;nuutila2_iterative
144;1000;200000;1;6803456;6893568;90112;pearce2_iterative
145;1000;699999;1;20996096;21082112;86016;pearce2_iterative
146;1000;9999;1;1826816;1896448;69632;pearce2_iterative
147;1000;200000;1;8683520;8876032;192512;boost
148;1000;699999;1;25403392;25432064;28672;boost
149;1000;9999;1;1822720;1982464;159744;boost
150;1000;200000;1;8560640;8646656;86016;nuutila1_iterative
151;1000;699999;1;24694784;24809472;114688;nuutila1_iterative
152;1000;9999;1;1826816;1896448;69632;nuutila1_iterative
153;1000;200000;1;7065600;7389184;323584;pearce1
154;1000;699999;1;24215552;24535040;319488;pearce1
155;1000;9999;1;1822720;2093056;270336;pearce1
156;1000;200000;1;8663040;8998912;335872;nuutila2
157;1000;699999;1;26365952;26693632;327680;nuutila2
158;1000;9999;1;1822720;2105344;282624;nuutila2
159;1000;200000;1;8810496;9134080;323584;nuutila1
160;1000;699999;1;24420352;24735744;315392;nuutila1
161;1000;9999;1;1892352;2162688;270336;nuutila1
162;1000;200000;1;9400320;9674752;274432;pearce2
163;1000;699999;1;18083840;18362368;278528;pearce2
164;1000;9999;1;1839104;2068480;229376;pearce2
165;1000;200000;1;8912896;9134080;221184;tarjan
166;1000;699999;1;25063424;25272320;208896;tarjan
167;1000;9999;1;1822720;2019328;196608;tarjan
168;1000;200000;1;7380992;7507968;126976;nuutila2_iterative
169;1000;699999;1;26865664;26951680;86016;nuutila2_iterative
170;1000;9999;1;1826816;1896448;69632;nuutila2_iterative
171;1000;200000;1;8663040;8753152;90112;pearce2_iterative
172;1000;699999;1;22274048;22380544;106496;pearce2_iterative
173;1000;9999;1;1826816;1896448;69632;pearce2_iterative
174;1000;200000;1;9490432;9515008;24576;boost
175;1000;699999;1;26447872;26472448;24576;boost
176;1000;9999;1;1822720;1982464;159744;boost
177;1000;200000;1;8531968;8638464;106496;nuutila1_iterative
178;1000;699999;1;22466560;22556672;90112;nuutila1_iterative
179;1000;9999;1;1826816;1896448;69632;nuutila1_iterative
180;1000;200000;1;7757824;8077312;319488;pearce1
181;1000;699999;1;25853952;26169344;315392;pearce1
182;1000;9999;1;1822720;2093056;270336;pearce1
183;1000;200000;1;8601600;8929280;327680;nuutila2
184;1000;699999;1;26746880;27082752;335872;nuutila2
185;1000;9999;1;1822720;2105344;282624;nuutila2
186;1000;200000;1;6774784;7098368;323584;nuutila1
187;1000;699999;1;24145920;24473600;327680;nuutila1
188;1000;9999;1;1822720;2097152;274432;nuutila1
189;10000;20000000;1;433049600;435957760;2908160;pearce2
190;10000;69999998;1;1334935552;1337872384;2936832;pearce2
191;10000;999999;1;33042432;35950592;2908160;pearce2
192;10000;20000000;1;434270208;436420608;2150400;tarjan
193;10000;69999998;1;1327894528;1330049024;2154496;tarjan
194;10000;999999;1;42651648;45023232;2371584;tarjan
195;10000;20000000;1;430874624;431517696;643072;nuutila2_iterative
196;10000;69999998;1;1334886400;1335504896;618496;nuutila2_iterative
197;10000;999999;1;40132608;40837120;704512;nuutila2_iterative
198;10000;20000000;1;440197120;440868864;671744;pearce2_iterative
199;10000;69999998;1;1323663360;1324318720;655360;pearce2_iterative
200;10000;999999;1;36290560;36884480;593920;pearce2_iterative
201;10000;20000000;1;431071232;433012736;1941504;boost
202;10000;69999998;1;1334759326;1336467358;1708032;boost
203;10000;999999;1;37744640;39792640;2048000;boost
204;10000;20000000;1;436064256;436752384;688128;nuutila1_iterative
205;10000;69999998;1;1331122176;1331765248;643072;nuutila1_iterative
206;10000;999999;1;39673856;40378368;704512;nuutila1_iterative
207;10000;20000000;1;442142720;445386752;3244032;pearce1
208;10000;69999998;1;1336475648;1339723776;3248128;pearce1
209;10000;999999;1;36462592;39690240;3227648;pearce1
210;10000;20000000;1;434659328;438013952;3354624;nuutila2
211;10000;69999998;1;1335816192;1339170816;3354624;nuutila2
212;10000;999999;1;40931328;44273664;3342336;nuutila2
213;10000;20000000;1;422420480;425672704;3252224;nuutila1
214;10000;69999998;1;1336139776;1339400192;3260416;nuutila1
215;10000;999999;1;36409344;39677952;3268608;nuutila1
216;10000;20000000;1;425164800;428089344;2924544;pearce2
217;10000;69999998;1;1333547008;1336475648;2928640;pearce2
218;10000;999999;1;39698432;42610688;2912256;pearce2
219;10000;20000000;1;427425792;429821952;2396160;tarjan
220;10000;69999998;1;1336676352;1338826752;2150400;tarjan
221;10000;999999;1;36499456;38866944;2367488;tarjan
222;10000;20000000;1;427872256;428531712;659456;nuutila2_iterative
223;10000;69999998;1;1325211648;1325834240;622592;nuutila2_iterative
224;10000;999999;1;38535168;39079936;544768;nuutila2_iterative
225;10000;20000000;1;422473728;423149568;675840;pearce2_iterative
226;10000;69999998;1;1338163200;1338822656;659456;pearce2_iterative
227;10000;999999;1;33845248;34504704;659456;pearce2_iterative
228;10000;20000000;1;439459840;441401344;1941504;boost
229;10000;69999998;1;1318760448;1320464384;1703936;boost
230;10000;999999;1;42639360;44335104;1695744;boost
231;10000;20000000;1;423182336;423821312;638976;nuutila1_iterative
232;10000;69999998;1;1332084736;1332727808;643072;nuutila1_iterative
233;10000;999999;1;39092224;39841792;749568;nuutila1_iterative
234;10000;20000000;1;427368448;430624768;3256320;pearce1
235;10000;69999998;1;1340776448;1344040960;3264512;pearce1
236;10000;999999;1;36986880;40173568;3186688;pearce1
237;10000;20000000;1;422051840;425406464;3354624;nuutila2
238;10000;69999998;1;1332166656;1335521280;3354624;nuutila2
239;10000;999999;1;39260160;42565632;3305472;nuutila2
240;10000;20000000;1;421576704;424828928;3252224;nuutila1
241;10000;69999998;1;1344286720;1347547136;3260416;nuutila1
242;10000;999999;1;41435136;44699648;3264512;nuutila1
243;10000;20000000;1;424169472;427134976;2965504;pearce2
244;10000;69999998;1;1335128064;1338064896;2936832;pearce2
245;10000;999999;1;37023744;39895040;2871296;pearce2
246;10000;20000000;1;424751104;427147264;2396160;tarjan
247;10000;69999998;1;1334718464;1336881152;2162688;tarjan
248;10000;999999;1;38293504;40431616;2138112;tarjan
249;10000;20000000;1;421318656;421953536;634880;nuutila2_iterative
250;10000;69999998;1;1322827776;1323446272;618496;nuutila2_iterative
251;10000;999999;1;39104512;39792640;688128;nuutila2_iterative
252;10000;20000000;1;419729408;420384768;655360;pearce2_iterative
253;10000;69999998;1;1335050240;1335705600;655360;pearce2_iterative
254;10000;999999;1;38952960;39587840;634880;pearce2_iterative
255;10000;20000000;1;420831232;422535168;1703936;boost
256;10000;69999998;1;1334775808;1336483840;1708032;boost
257;10000;999999;1;40054784;42053632;1998848;boost
258;10000;20000000;1;420392960;421052416;659456;nuutila1_iterative
259;10000;69999998;1;1329545216;1330192384;647168;nuutila1_iterative
260;10000;999999;1;39342080;39989248;647168;nuutila1_iterative
261;10000;20000000;1;428769280;432025600;3256320;pearce1
262;10000;69999998;1;1339150336;1342402560;3252224;pearce1
263;10000;999999;1;36753408;39985152;3231744;pearce1
264;10000;20000000;1;431194112;434552832;3358720;nuutila2
265;10000;69999998;1;1345429504;1348784128;3354624;nuutila2
266;10000;999999;1;35282944;38674432;3391488;nuutila2
267;10000;20000000;1;422518784;425775104;3256320;nuutila1
268;10000;69999998;1;1340026880;1343291392;3264512;nuutila1
269;10000;999999;1;38436864;41701376;3264512;nuutila1
270;10000;20000000;1;428896256;431812608;2916352;pearce2
271;10000;69999998;1;1345642496;1348575232;2932736;pearce2
272;10000;999999;1;37371904;40275968;2904064;pearce2
273;10000;20000000;1;427515904;429924352;2408448;tarjan
274;10000;69999998;1;1322364928;1324535808;2170880;tarjan
275;10000;999999;1;37044224;39170048;2125824;tarjan
276;10000;20000000;1;425259008;425955328;696320;nuutila2_iterative
277;10000;69999998;1;1334288384;1334906880;618496;nuutila2_iterative
278;10000;999999;1;37781504;38453248;671744;nuutila2_iterative
279;10000;20000000;1;432013312;432672768;659456;pearce2_iterative
280;10000;69999998;1;1336619008;1337290752;671744;pearce2_iterative
281;10000;999999;1;37425152;38002688;577536;pearce2_iterative
282;10000;20000000;1;424497152;426434560;1937408;boost
283;10000;69999998;1;1331134464;1332842496;1708032;boost
284;10000;999999;1;39456768;41496576;2039808;boost
285;10000;20000000;1;426090496;426749952;659456;nuutila1_iterative
286;10000;69999998;1;1323966464;1324695552;729088;nuutila1_iterative
287;10000;999999;1;38526976;39116800;589824;nuutila1_iterative
288;10000;20000000;1;420843520;424091648;3248128;pearce1
289;10000;69999998;1;1338052608;1341304832;3252224;pearce1
290;10000;999999;1;37728256;40960000;3231744;pearce1
291;10000;20000000;1;429105152;432459776;3354624;nuutila2
292;10000;69999998;1;1329467392;1332822016;3354624;nuutila2
293;10000;999999;1;39178240;42569728;3391488;nuutila2
294;10000;20000000;1;421842944;425095168;3252224;nuutila1
295;10000;69999998;1;1329463296;1332727808;3264512;nuutila1
296;10000;999999;1;40247296;43532288;3284992;nuutila1
297;10000;20000000;1;424292352;427216896;2924544;pearce2
298;10000;69999998;1;1336385536;1339310080;2924544;pearce2
299;10000;999999;1;38240256;41144320;2904064;pearce2
300;10000;20000000;1;421715968;424108032;2392064;tarjan
301;10000;69999998;1;1342869504;1345015808;2146304;tarjan
302;10000;999999;1;40144896;42508288;2363392;tarjan
303;10000;20000000;1;420012032;420630528;618496;nuutila2_iterative
304;10000;69999998;1;1336778752;1337405440;626688;nuutila2_iterative
305;10000;999999;1;38596608;39297024;700416;nuutila2_iterative
306;10000;20000000;1;430256128;430919680;663552;pearce2_iterative
307;10000;69999998;1;1327292416;1327935488;643072;pearce2_iterative
308;10000;999999;1;39542784;40222720;679936;pearce2_iterative
309;10000;20000000;1;423862272;425816064;1953792;boost
310;10000;69999998;1;1335246848;1336946688;1699840;boost
311;10000;999999;1;43155456;45207552;2052096;boost
312;10000;20000000;1;425152512;425820160;667648;nuutila1_iterative
313;10000;69999998;1;1319305216;1319976960;671744;nuutila1_iterative
314;10000;999999;1;38305792;39051264;745472;nuutila1_iterative
315;10000;20000000;1;425414656;428666880;3252224;pearce1
316;10000;69999998;1;1340260352;1343516672;3256320;pearce1
317;10000;999999;1;38817792;42061824;3244032;pearce1
318;10000;20000000;1;427601920;430960640;3358720;nuutila2
319;10000;69999998;1;1334272000;1337626624;3354624;nuutila2
320;10000;999999;1;35381248;38768640;3387392;nuutila2
321;10000;20000000;1;424448000;427700224;3252224;nuutila1
322;10000;69999998;1;1327542272;1330790400;3248128;nuutila1
323;10000;999999;1;39088128;42274816;3186688;nuutila1
324;10000;20000000;1;430411776;433336320;2924544;pearce2
325;10000;69999998;1;1327296512;1330225152;2928640;pearce2
326;10000;999999;1;39796736;42708992;2912256;pearce2
327;10000;20000000;1;419397632;421789696;2392064;tarjan
328;10000;69999998;1;1341562880;1343717376;2154496;tarjan
329;10000;999999;1;42082304;44404736;2322432;tarjan
330;10000;20000000;1;425345024;425967616;622592;nuutila2_iterative
331;10000;69999998;1;1324258475;1334906880;618496;nuutila2_iterative
332;10000;999999;1;39960576;40648704;688128;nuutila2_iterative
333;10000;20000000;1;418750464;419393536;643072;pearce2_iterative
334;10000;69999998;1;1331834880;1332502528;667648;pearce2_iterative
335;10000;999999;1;37457920;38047744;589824;pearce2_iterative
336;10000;20000000;1;431427584;433156096;1728512;boost
337;10000;69999998;1;1332858880;1334562816;1703936;boost
338;10000;999999;1;37986304;39923712;1937408;boost
339;10000;20000000;1;422678528;423329792;651264;nuutila1_iterative
340;10000;69999998;1;1333202944;1333841920;638976;nuutila1_iterative
341;10000;999999;1;38637568;39268352;630784;nuutila1_iterative
342;10000;20000000;1;421916672;425172992;3256320;pearce1
343;10000;69999998;1;1333411840;1336668160;3256320;pearce1
344;10000;999999;1;36913152;40144896;3231744;pearce1
345;10000;20000000;1;426991616;430346240;3354624;nuutila2
346;10000;69999998;1;1327759360;1331113984;3354624;nuutila2
347;10000;999999;1;39383040;42774528;3391488;nuutila2
348;10000;20000000;1;424714240;427966464;3252224;nuutila1
349;10000;69999998;1;1344331776;1347600384;3268608;nuutila1
350;10000;999999;1;36392960;39665664;3272704;nuutila1
351;10000;20000000;1;424349696;427278336;2928640;pearce2
352;10000;69999998;1;1321099264;1324027904;2928640;pearce2
353;10000;999999;1;39063552;41922560;2859008;pearce2
354;10000;20000000;1;423604224;425758720;2154496;tarjan
355;10000;69999998;1;1323855872;1326018560;2162688;tarjan
356;10000;999999;1;40407040;42782720;2375680;tarjan
357;10000;20000000;1;433176576;433799168;622592;nuutila2_iterative
358;10000;69999998;1;1335799808;1336422400;622592;nuutila2_iterative
359;10000;999999;1;36368384;37093376;724992;nuutila2_iterative
360;10000;20000000;1;426209280;426881024;671744;pearce2_iterative
361;10000;69999998;1;1328521216;1329180672;659456;pearce2_iterative
362;10000;999999;1;38293504;39010304;716800;pearce2_iterative
363;10000;20000000;1;426668032;428609536;1941504;boost
364;10000;69999998;1;1327620096;1329336320;1716224;boost
365;10000;999999;1;36700160;38334464;1634304;boost
366;10000;20000000;1;421335040;421994496;659456;nuutila1_iterative
367;10000;69999998;1;1337892864;1338560512;667648;nuutila1_iterative
368;10000;999999;1;36003840;36745216;741376;nuutila1_iterative
369;10000;20000000;1;426930176;430194688;3264512;pearce1
370;10000;69999998;1;1334685696;1337942016;3256320;pearce1
371;10000;999999;1;36634624;39870464;3235840;pearce1
372;10000;20000000;1;425230336;428589056;3358720;nuutila2
373;10000;69999998;1;1336107008;1339461632;3354624;nuutila2
374;10000;999999;1;37675008;41062400;3387392;nuutila2
375;10000;20000000;1;427712512;430956544;3244032;nuutila1
376;10000;69999998;1;1339703296;1342959616;3256320;nuutila1
377;10000;999999;1;40869888;44101632;3231744;nuutila1
378;5000;5000000;1;125751296;127205376;1454080;pearce2
379;5000;17499999;1;367980544;369463296;1482752;pearce2
380;5000;249999;1;12812288;14209024;1396736;pearce2
381;5000;5000000;1;119640064;120832000;1191936;tarjan
382;5000;17499999;1;359596032;360681472;1085440;tarjan
383;5000;249999;1;12705792;13819904;1114112;tarjan
384;5000;5000000;1;128569344;128905216;335872;nuutila2_iterative
385;5000;17499999;1;369098752;369496064;397312;nuutila2_iterative
386;5000;249999;1;13324288;13410304;86016;nuutila2_iterative
387;5000;5000000;1;122368000;122712064;344064;pearce2_iterative
388;5000;17499999;1;358264832;358621184;356352;pearce2_iterative
389;5000;249999;1;12611584;12890112;278528;pearce2_iterative
390;5000;5000000;1;120213504;121274368;1060864;boost
391;5000;17499999;1;363106304;364146688;1040384;boost
392;5000;249999;1;12304384;13389824;1085440;boost
393;5000;5000000;1;119959552;120303616;344064;nuutila1_iterative
394;5000;17499999;1;360308736;360677376;368640;nuutila1_iterative
395;5000;249999;1;11984896;12337152;352256;nuutila1_iterative
396;5000;5000000;1;121479168;123101184;1622016;pearce1
397;5000;17499999;1;370376704;372019200;1642496;pearce1
398;5000;249999;1;13262848;14852096;1589248;pearce1
399;5000;5000000;1;119164928;120840192;1675264;nuutila2
400;5000;17499999;1;366460928;368136192;1675264;nuutila2
401;5000;249999;1;13221888;14893056;1671168;nuutila2
402;5000;5000000;1;121516032;123146240;1630208;nuutila1
403;5000;17499999;1;370176000;371851264;1675264;nuutila1
404;5000;249999;1;12292096;13897728;1605632;nuutila1
405;5000;5000000;1;120135680;121581568;1445888;pearce2
406;5000;17499999;1;362737664;364208128;1470464;pearce2
407;5000;249999;1;12697600;14118912;1421312;pearce2
408;5000;5000000;1;128724992;129921024;1196032;tarjan
409;5000;17499999;1;369692672;370769920;1077248;tarjan
410;5000;249999;1;11403264;12566528;1163264;tarjan
411;5000;5000000;1;116563968;116944896;380928;nuutila2_iterative
412;5000;17499999;1;356528128;356851712;323584;nuutila2_iterative
413;5000;249999;1;11403264;11763712;360448;nuutila2_iterative
414;5000;5000000;1;126275584;126595072;319488;pearce2_iterative
415;5000;17499999;1;368107520;368414720;307200;pearce2_iterative
416;5000;249999;1;11636736;11976704;339968;pearce2_iterative
417;5000;5000000;1;115671040;116535296;864256;boost
418;5000;17499999;1;354398208;355360768;962560;boost
419;5000;249999;1;12148736;13209600;1060864;boost
420;5000;5000000;1;120942592;121331712;389120;nuutila1_iterative
421;5000;17499999;1;383922176;384323584;401408;nuutila1_iterative
422;5000;249999;1;11665408;12021760;356352;nuutila1_iterative
423;5000;5000000;1;126894080;128516096;1622016;pearce1
424;5000;17499999;1;364335104;365981696;1646592;pearce1
425;5000;249999;1;12062720;13656064;1593344;pearce1
426;5000;5000000;1;113451008;115126272;1675264;nuutila2
427;5000;17499999;1;362946560;364662784;1716224;nuutila2
428;5000;249999;1;11403264;13074432;1671168;nuutila2
429;5000;5000000;1;116998144;118624256;1626112;nuutila1
430;5000;17499999;1;367661056;369278976;1617920;nuutila1
431;5000;249999;1;11522048;13144064;1622016;nuutila1
432;5000;5000000;1;122626048;124100608;1474560;pearce2
433;5000;17499999;1;355987456;357441536;1454080;pearce2
434;5000;249999;1;12996608;14393344;1396736;pearce2
435;5000;5000000;1;117510144;118665216;1155072;tarjan
436;5000;17499999;1;371535872;372699136;1163264;tarjan
437;5000;249999;1;11403264;12566528;1163264;tarjan
438;5000;5000000;1;120844288;121180160;335872;nuutila2_iterative
439;5000;17499999;1;375615488;375951360;335872;nuutila2_iterative
440;5000;249999;1;13369344;13725696;356352;nuutila2_iterative
441;5000;5000000;1;121339904;121692160;352256;pearce2_iterative
442;5000;17499999;1;363356160;363720704;364544;pearce2_iterative
443;5000;249999;1;12156928;12214272;57344;pearce2_iterative
444;5000;5000000;1;120967168;122023936;1056768;boost
445;5000;17499999;1;367767552;368635904;868352;boost
446;5000;249999;1;12111872;13209600;1097728;boost
447;5000;5000000;1;121335808;121696256;360448;nuutila1_iterative
448;5000;17499999;1;391905280;392269824;364544;nuutila1_iterative
449;5000;249999;1;11620352;11694080;73728;nuutila1_iterative
450;5000;5000000;1;127086592;128704512;1617920;pearce1
451;5000;17499999;1;372822016;374444032;1622016;pearce1
452;5000;249999;1;12607488;14196736;1589248;pearce1
453;5000;5000000;1;129110016;130822144;1712128;nuutila2
454;5000;17499999;1;366198784;367915008;1716224;nuutila2
455;5000;249999;1;12443648;14106624;1662976;nuutila2
456;5000;5000000;1;124592128;126210048;1617920;nuutila1
457;5000;17499999;1;380899328;382558208;1658880;nuutila1
458;5000;249999;1;12746752;14340096;1593344;nuutila1
459;5000;5000000;1;121729024;123174912;1445888;pearce2
460;5000;17499999;1;357269504;358735872;1466368;pearce2
461;5000;249999;1;11403264;12828672;1425408;pearce2
462;5000;5000000;1;134377472;135569408;1191936;tarjan
463;5000;17499999;1;379248640;380321792;1073152;tarjan
464;5000;249999;1;12902400;14069760;1167360;tarjan
465;5000;5000000;1;127938560;128307200;368640;nuutila2_iterative
466;5000;17499999;1;388177920;388497408;319488;nuutila2_iterative
467;5000;249999;1;11403264;11763712;360448;nuutila2_iterative
468;5000;5000000;1;127705088;128032768;327680;pearce2_iterative
469;5000;17499999;1;362684416;363028480;344064;pearce2_iterative
470;5000;249999;1;13144064;13479936;335872;pearce2_iterative
471;5000;5000000;1;128598016;129482752;884736;boost
472;5000;17499999;1;370053120;370913280;860160;boost
473;5000;249999;1;11403264;12505088;1101824;boost
474;5000;5000000;1;128577536;128884736;307200;nuutila1_iterative
475;5000;17499999;1;370839552;371236864;397312;nuutila1_iterative
476;5000;249999;1;11403264;11763712;360448;nuutila1_iterative
477;5000;5000000;1;125722624;127336448;1613824;pearce1
478;5000;17499999;1;363974656;365592576;1617920;pearce1
479;5000;249999;1;11931648;13492224;1560576;pearce1
480;5000;5000000;1;122494976;124186624;1691648;nuutila2
481;5000;17499999;1;363175936;364855296;1679360;nuutila2
482;5000;249999;1;11403264;13074432;1671168;nuutila2
483;5000;5000000;1;123506688;125128704;1622016;nuutila1
484;5000;17499999;1;351576064;353193984;1617920;nuutila1
485;5000;249999;1;11534336;13131776;1597440;nuutila1
486;5000;5000000;1;134889472;136335360;1445888;pearce2
487;5000;17499999;1;364785664;366231552;1445888;pearce2
488;5000;249999;1;12496896;13893632;1396736;pearce2
489;5000;5000000;1;131694592;132767744;1073152;tarjan
490;5000;17499999;1;363503616;364572672;1069056;tarjan
491;5000;249999;1;11726848;12840960;1114112;tarjan
492;5000;5000000;1;127971328;128294912;323584;nuutila2_iterative
493;5000;17499999;1;355819520;356134912;315392;nuutila2_iterative
494;5000;249999;1;11497472;11845632;348160;nuutila2_iterative
495;5000;5000000;1;121769984;122138624;368640;pearce2_iterative
496;5000;17499999;1;369717248;370094080;376832;pearce2_iterative
497;5000;249999;1;11403264;11743232;339968;pearce2_iterative
498;5000;5000000;1;123805696;124665856;860160;boost
499;5000;17499999;1;388714496;389787648;1073152;boost
500;5000;249999;1;11403264;12505088;1101824;boost
501;5000;5000000;1;136200192;136511488;311296;nuutila1_iterative
502;5000;17499999;1;389644288;389980160;335872;nuutila1_iterative
503;5000;249999;1;11440128;11792384;352256;nuutila1_iterative
504;5000;5000000;1;127078400;128692224;1613824;pearce1
505;5000;17499999;1;383107072;384733184;1626112;pearce1
506;5000;249999;1;11403264;12996608;1593344;pearce1
507;5000;5000000;1;119676928;121352192;1675264;nuutila2
508;5000;17499999;1;380440576;382115840;1675264;nuutila2
509;5000;249999;1;11509760;13172736;1662976;nuutila2
510;5000;5000000;1;127647744;129261568;1613824;nuutila1
511;5000;17499999;1;375504896;377122816;1617920;nuutila1
512;5000;249999;1;12267520;13848576;1581056;nuutila1
513;5000;5000000;1;123944960;125394944;1449984;pearce2
514;5000;17499999;1;374927360;376377344;1449984;pearce2
515;5000;249999;1;12980224;14393344;1413120;pearce2
516;5000;5000000;1;130224128;131420160;1196032;tarjan
517;5000;17499999;1;368578560;369651712;1073152;tarjan
518;5000;249999;1;12255232;13369344;1114112;tarjan
519;5000;5000000;1;123834368;124166144;331776;nuutila2_iterative
520;5000;17499999;1;373264384;373665792;401408;nuutila2_iterative
521;5000;249999;1;11403264;11763712;360448;nuutila2_iterative
522;5000;5000000;1;119341056;119693312;352256;pearce2_iterative
523;5000;17499999;1;380936192;381284352;348160;pearce2_iterative
524;5000;249999;1;12840960;13185024;344064;pearce2_iterative
525;5000;5000000;1;127606784;128643072;1036288;boost
526;5000;17499999;1;374910976;375771136;860160;boost
527;5000;249999;1;12738560;13824000;1085440;boost
528;5000;5000000;1;120762368;121176064;413696;nuutila1_iterative
529;5000;17499999;1;352374784;352739328;364544;nuutila1_iterative
530;5000;249999;1;12603392;12967936;364544;nuutila1_iterative
531;5000;5000000;1;121511936;123142144;1630208;pearce1
532;5000;17499999;1;373207040;374861824;1654784;pearce1
533;5000;249999;1;12951552;14540800;1589248;pearce1
534;5000;5000000;1;122716160;124387328;1671168;nuutila2
535;5000;17499999;1;360288256;361963520;1675264;nuutila2
536;5000;249999;1;12128256;13791232;1662976;nuutila2
537;5000;5000000;1;120942592;122568704;1626112;nuutila1
538;5000;17499999;1;359804928;361435136;1630208;nuutila1
539;5000;249999;1;12341248;13950976;1609728;nuutila1
540;5000;5000000;1;127361024;128806912;1445888;pearce2
541;5000;17499999;1;368373760;369856512;1482752;pearce2
542;5000;249999;1;12681216;14090240;1409024;pearce2
543;5000;5000000;1;117723136;118919168;1196032;tarjan
544;5000;17499999;1;358084608;359157760;1073152;tarjan
545;5000;249999;1;11632640;12800000;1167360;tarjan
546;5000;5000000;1;120918016;121257984;339968;nuutila2_iterative
547;5000;17499999;1;369811456;370200576;389120;nuutila2_iterative
548;5000;249999;1;13398016;13631488;233472;nuutila2_iterative
549;5000;5000000;1;119001088;119361536;360448;pearce2_iterative
550;5000;17499999;1;371167232;371527680;360448;pearce2_iterative
551;5000;249999;1;12488704;12554240;65536;pearce2_iterative
552;5000;5000000;1;121999360;123052032;1052672;boost
553;5000;17499999;1;364359680;365277184;917504;boost
554;5000;249999;1;12455936;13557760;1101824;boost
555;5000;5000000;1;120471552;120819712;348160;nuutila1_iterative
556;5000;17499999;1;358494208;358846464;352256;nuutila1_iterative
557;5000;249999;1;12394496;12746752;352256;nuutila1_iterative
558;5000;5000000;1;118497280;120131584;1634304;pearce1
559;5000;17499999;1;354238464;355893248;1654784;pearce1
560;5000;249999;1;12742656;14307328;1564672;pearce1
561;5000;5000000;1;118169600;119844864;1675264;nuutila2
562;5000;17499999;1;360771584;362446848;1675264;nuutila2
563;5000;249999;1;12537856;14204928;1667072;nuutila2
564;5000;5000000;1;124116992;125739008;1622016;nuutila1
565;5000;17499999;1;363556864;365182976;1626112;nuutila1
566;5000;249999;1;12693504;14278656;1585152;nuutila1
567;3000;1800000;1;58310656;59183104;872448;pearce2
568;3000;6299999;1;175235072;176095232;860160;pearce2
569;3000;89999;1;6311936;7139328;827392;pearce2
570;3000;1800000;1;63356928;63995904;638976;tarjan
571;3000;6299999;1;174698496;175411200;712704;tarjan
572;3000;89999;1;6021120;6701056;679936;tarjan
573;3000;1800000;1;55066624;55291904;225280;nuutila2_iterative
574;3000;6299999;1;177926144;178167808;241664;nuutila2_iterative
575;3000;89999;1;5300224;5455872;155648;nuutila2_iterative
576;3000;1800000;1;61661184;61890560;229376;pearce2_iterative
577;3000;6299999;1;178630656;178855936;225280;pearce2_iterative
578;3000;89999;1;5492736;5586944;94208;pearce2_iterative
579;3000;1800000;1;55996416;56414208;417792;boost
580;3000;6299999;1;181202944;181714944;512000;boost
581;3000;89999;1;6180864;6782976;602112;boost
582;3000;1800000;1;59019264;59236352;217088;nuutila1_iterative
583;3000;6299999;1;183119872;183357440;237568;nuutila1_iterative
584;3000;89999;1;5681152;5738496;57344;nuutila1_iterative
585;3000;1800000;1;55300096;56270848;970752;pearce1
586;3000;6299999;1;185311232;186302464;991232;pearce1
587;3000;89999;1;5918720;6852608;933888;pearce1
588;3000;1800000;1;61063168;62066688;1003520;nuutila2
589;3000;6299999;1;181506048;182513664;1007616;nuutila2
590;3000;89999;1;6283264;7249920;966656;nuutila2
591;3000;1800000;1;55930880;56897536;966656;nuutila1
592;3000;6299999;1;179351552;180334592;983040;nuutila1
593;3000;89999;1;5189632;6111232;921600;nuutila1
594;3000;1800000;1;66772992;67633152;860160;pearce2
595;3000;6299999;1;185135104;185995264;860160;pearce2
596;3000;89999;1;5713920;6541312;827392;pearce2
597;3000;1800000;1;68583424;69222400;638976;tarjan
598;3000;6299999;1;178794496;179515392;720896;tarjan
599;3000;89999;1;5496832;6176768;679936;tarjan
600;3000;1800000;1;64696320;64905216;208896;nuutila2_iterative
601;3000;6299999;1;177594368;177807360;212992;nuutila2_iterative
602;3000;89999;1;5189632;5287936;98304;nuutila2_iterative
603;3000;1800000;1;61546496;61771776;225280;pearce2_iterative
604;3000;6299999;1;182759424;183005184;245760;pearce2_iterative
605;3000;89999;1;5632000;5705728;73728;pearce2_iterative
606;3000;1800000;1;59129856;59727872;598016;boost
607;3000;6299999;1;175824896;176234496;409600;boost
608;3000;89999;1;5693440;6311936;618496;boost
609;3000;1800000;1;61169664;61407232;237568;nuutila1_iterative
610;3000;6299999;1;177344512;177586176;241664;nuutila1_iterative
611;3000;89999;1;5201920;5300224;98304;nuutila1_iterative
612;3000;1800000;1;60092416;61054976;962560;pearce1
613;3000;6299999;1;184557568;185548800;991232;pearce1
614;3000;89999;1;5550080;6475776;925696;pearce1
615;3000;1800000;1;59432960;60436480;1003520;nuutila2
616;3000;6299999;1;175022080;176033792;1011712;nuutila2
617;3000;89999;1;6266880;7241728;974848;nuutila2
618;3000;1800000;1;60465152;61464576;999424;nuutila1
619;3000;6299999;1;181071872;182046720;974848;nuutila1
620;3000;89999;1;6017024;6938624;921600;nuutila1
621;3000;1800000;1;66289664;67149824;860160;pearce2
622;3000;6299999;1;176250880;177123328;872448;pearce2
623;3000;89999;1;5623808;6451200;827392;pearce2
624;3000;1800000;1;56225792;56864768;638976;tarjan
625;3000;6299999;1;176218112;176885760;667648;tarjan
626;3000;89999;1;5779456;6459392;679936;tarjan
627;3000;1800000;1;58003456;58249216;245760;nuutila2_iterative
628;3000;6299999;1;183717888;183943168;225280;nuutila2_iterative
629;3000;89999;1;6254592;6467584;212992;nuutila2_iterative
630;3000;1800000;1;61054976;61263872;208896;pearce2_iterative
631;3000;6299999;1;201265152;201502720;237568;pearce2_iterative
632;3000;89999;1;5206016;5292032;86016;pearce2_iterative
633;3000;1800000;1;57835520;58249216;413696;boost
634;3000;6299999;1;177405952;177811456;405504;boost
635;3000;89999;1;6258688;6860800;602112;boost
636;3000;1800000;1;55750656;55988224;237568;nuutila1_iterative
637;3000;6299999;1;177000448;177225728;225280;nuutila1_iterative
638;3000;89999;1;5922816;6139904;217088;nuutila1_iterative
639;3000;1800000;1;64638976;65601536;962560;pearce1
640;3000;6299999;1;186736640;187719680;983040;pearce1
641;3000;89999;1;5234688;6144000;909312;pearce1
642;3000;1800000;1;60481536;61485056;1003520;nuutila2
643;3000;6299999;1;176914432;177917952;1003520;nuutila2
644;3000;89999;1;5271552;6242304;970752;nuutila2
645;3000;1800000;1;61833216;62803968;970752;nuutila1
646;3000;6299999;1;177246208;178221056;974848;nuutila1
647;3000;89999;1;5955584;6893568;937984;nuutila1
648;3000;1800000;1;60452864;61325312;872448;pearce2
649;3000;6299999;1;179822592;180682752;860160;pearce2
650;3000;89999;1;5533696;6365184;831488;pearce2
651;3000;1800000;1;64069632;64794624;724992;tarjan
652;3000;6299999;1;177754112;178393088;638976;tarjan
653;3000;89999;1;5484544;6164480;679936;tarjan
654;3000;1800000;1;61059072;61284352;225280;nuutila2_iterative
655;3000;6299999;1;176111616;176349184;237568;nuutila2_iterative
656;3000;89999;1;5328896;5447680;118784;nuutila2_iterative
657;3000;1800000;1;60678144;60911616;233472;pearce2_iterative
658;3000;6299999;1;175087616;175337472;249856;pearce2_iterative
659;3000;89999;1;6254592;6467584;212992;pearce2_iterative
660;3000;1800000;1;58286080;58695680;409600;boost
661;3000;6299999;1;177565696;178061312;495616;boost
662;3000;89999;1;6123520;6656000;532480;boost
663;3000;1800000;1;59060224;59322368;262144;nuutila1_iterative
664;3000;6299999;1;181395456;181620736;225280;nuutila1_iterative
665;3000;89999;1;5652480;5873664;221184;nuutila1_iterative
666;3000;1800000;1;59670528;60641280;970752;pearce1
667;3000;6299999;1;179511296;180486144;974848;pearce1
668;3000;89999;1;5464064;6385664;921600;pearce1
669;3000;1800000;1;58839040;59842560;1003520;nuutila2
670;3000;6299999;1;182616064;183623680;1007616;nuutila2
671;3000;89999;1;5976064;6942720;966656;nuutila2
672;3000;1800000;1;59015168;59981824;966656;nuutila1
673;3000;6299999;1;180547584;181518336;970752;nuutila1
674;3000;89999;1;5894144;6815744;921600;nuutila1
675;3000;1800000;1;57475072;58343424;868352;pearce2
676;3000;6299999;1;185626624;186503168;876544;pearce2
677;3000;89999;1;5689344;6504448;815104;pearce2
678;3000;1800000;1;56320000;57036800;716800;tarjan
679;3000;6299999;1;174542848;175194112;651264;tarjan
680;3000;89999;1;5980160;6631424;651264;tarjan
681;3000;1800000;1;59068416;59277312;208896;nuutila2_iterative
682;3000;6299999;1;177303552;177532928;229376;nuutila2_iterative
683;3000;89999;1;5361664;5582848;221184;nuutila2_iterative
684;3000;1800000;1;56459264;56700928;241664;pearce2_iterative
685;3000;6299999;1;178401280;178651136;249856;pearce2_iterative
686;3000;89999;1;5591040;5705728;114688;pearce2_iterative
687;3000;1800000;1;59650048;60055552;405504;boost
688;3000;6299999;1;175153152;175640576;487424;boost
689;3000;89999;1;5660672;6262784;602112;boost
690;3000;1800000;1;56483840;56709120;225280;nuutila1_iterative
691;3000;6299999;1;177745920;178024448;278528;nuutila1_iterative
692;3000;89999;1;5951488;6168576;217088;nuutila1_iterative
693;3000;1800000;1;61194240;62156800;962560;pearce1
694;3000;6299999;1;185233408;186220544;987136;pearce1
695;3000;89999;1;5591040;6520832;929792;pearce1
696;3000;1800000;1;57040896;58040320;999424;nuutila2
697;3000;6299999;1;182063104;183070720;1007616;nuutila2
698;3000;89999;1;6316032;7294976;978944;nuutila2
699;3000;1800000;1;55635968;56598528;962560;nuutila1
700;3000;6299999;1;176566272;177549312;983040;nuutila1
701;3000;89999;1;5410816;6365184;954368;nuutila1
702;3000;1800000;1;56721408;57581568;860160;pearce2
703;3000;6299999;1;180449280;181338112;888832;pearce2
704;3000;89999;1;5935104;6746112;811008;pearce2
705;3000;1800000;1;59936768;60653568;716800;tarjan
706;3000;6299999;1;174759936;175398912;638976;tarjan
707;3000;89999;1;5967872;6651904;684032;tarjan
708;3000;1800000;1;61489152;61706240;217088;nuutila2_iterative
709;3000;6299999;1;182927360;183152640;225280;nuutila2_iterative
710;3000;89999;1;6049792;6168576;118784;nuutila2_iterative
711;3000;1800000;1;56860672;57081856;221184;pearce2_iterative
712;3000;6299999;1;194842624;195092480;249856;pearce2_iterative
713;3000;89999;1;5951488;6094848;143360;pearce2_iterative
714;3000;1800000;1;57810944;58388480;577536;boost
715;3000;6299999;1;175751168;176226304;475136;boost
716;3000;89999;1;5722112;6344704;622592;boost
717;3000;1800000;1;62517248;62742528;225280;nuutila1_iterative
718;3000;6299999;1;187027456;187265024;237568;nuutila1_iterative
719;3000;89999;1;5246976;5496832;249856;nuutila1_iterative
720;3000;1800000;1;62365696;63344640;978944;pearce1
721;3000;6299999;1;180584448;181579776;995328;pearce1
722;3000;89999;1;5562368;6479872;917504;pearce1
723;3000;1800000;1;55648256;56651776;1003520;nuutila2
724;3000;6299999;1;182059008;183066624;1007616;nuutila2
725;3000;89999;1;5324800;6291456;966656;nuutila2
726;3000;1800000;1;61767680;62738432;970752;nuutila1
727;3000;6299999;1;178769920;179744768;974848;nuutila1
728;3000;89999;1;5935104;6877184;942080;nuutila1
729;3000;1800000;1;57159680;58019840;860160;pearce2
730;3000;6299999;1;177991680;178860032;868352;pearce2
731;3000;89999;1;5394432;6221824;827392;pearce2
732;3000;1800000;1;56086528;56725504;638976;tarjan
733;3000;6299999;1;181985280;182628352;643072;tarjan
734;3000;89999;1;6029312;6721536;692224;tarjan
735;3000;1800000;1;61210624;61255680;45056;nuutila2_iterative
736;3000;6299999;1;177745920;177975296;229376;nuutila2_iterative
737;3000;89999;1;5488640;5701632;212992;nuutila2_iterative
738;3000;1800000;1;67440640;67665920;225280;pearce2_iterative
739;3000;6299999;1;183767040;183996416;229376;pearce2_iterative
740;3000;89999;1;5332992;5382144;49152;pearce2_iterative
741;3000;1800000;1;59035648;59453440;417792;boost
742;3000;6299999;1;184926208;185405440;479232;boost
743;3000;89999;1;6168576;6766592;598016;boost
744;3000;1800000;1;62795776;63029248;233472;nuutila1_iterative
745;3000;6299999;1;177405952;177643520;237568;nuutila1_iterative
746;3000;89999;1;6320128;6443008;122880;nuutila1_iterative
747;3000;1800000;1;63848448;64819200;970752;pearce1
748;3000;6299999;1;177123328;178102272;978944;pearce1
749;3000;89999;1;5566464;6492160;925696;pearce1
750;3000;1800000;1;58994688;59998208;1003520;nuutila2
751;3000;6299999;1;186183680;187191296;1007616;nuutila2
752;3000;89999;1;6033408;7000064;966656;nuutila2
753;3000;1800000;1;62730240;63709184;978944;nuutila1
754;3000;6299999;1;179302400;180285440;983040;nuutila1
755;3000;89999;1;5459968;6397952;937984;nuutila1
